0:NetherFloor
1:NetherTorch
2:NetherWall
-
2 1 0 0 0 0 0 1 0 0 0 0 0 1 2
1 1 0 0 0 0 0 0 0 0 0 0 0 1 1
0 0 0 0 0 0 0 0 0 0 0 0 0 0 0
0 0 0 0 0 0 0 0 0 0 0 0 0 0 0
1 0 0 0 0 0 0 0 0 0 0 0 0 0 1
0 0 0 0 0 0 0 0 0 0 0 0 0 0 0
0 0 0 0 0 0 0 0 0 0 0 0 0 0 0
1 1 0 0 0 0 0 0 0 0 0 0 0 1 1
2 1 0 0 0 0 0 1 0 0 0 0 0 1 2